64 64
@ @ @ . @ @ @ @ @ @ @ @ @ @ @ @ @ @ @ . @ @ @ @ @ @ . @ @ @ @ @ @ @ . @ @ @ @ @ @ @ @ @ @ @ @ @ @ . @ @ @ @ @ @ @ . @ @ @ @ @ @
@ . . . . . . . @ . . . . . . . @ . . . . . . . @ . . . . . . . @ . . . . . . . @ . . . . . . . @ . . . . . . . @ . . . . . . .
@ . . . . . . . @ . . . . . . . @ . . . . . . . @ . . . . . . . @ . . . . . . . @ . . . . . . . @ . . . . . . . @ . . . . . . .
. . . . . . . . @ . . . . . . . @ . . . . . . . @ . . . . . . . @ . . . . . . . @ . . . . . . . @ . . . . . . . @ . . . . . . .
@ . . . . . . . @ . . . . . . . @ . . . . . . . @ . . . . . . . @ . . . . . . . @ . . . . . . . @ . . . . . . . @ . . . . . . .
@ . . . . . . . . . . . . . . . . . . . . . . . @ . . . . . . . @ . . . . . . . @ . . . . . . . @ . . . . . . . . . . . . . . .
@ . . . . . . . @ . . . . . . . @ . . . . . . . @ . . . . . . . @ . . . . . . . @ . . . . . . . @ . . . . . . . @ . . . . . . .
@ . . . . . . . @ . . . . . . . @ . . . . . . . . . . . . . . . . . . . . . . . @ . . . . . . . . . . . . . . . @ . . . . . . .
@ . @ @ @ @ @ @ @ @ @ @ @ . @ @ @ @ @ @ @ . @ @ @ . @ @ @ @ @ @ @ . @ @ @ @ @ @ @ @ @ @ @ @ @ . @ @ @ @ @ @ . @ @ . @ @ @ @ @ @
@ . . . . . . . @ . . . . . . . @ . . . . . . . @ . . . . . . . @ . . . . . . . @ . . . . . . . @ . . . . . . . @ . . . . . . .
@ . . . . . . . @ . . . . . . . @ . . . . . . . . . . . . . . . . . . . . . . . @ . . . . . . . @ . . . . . . . @ . . . . . . .
@ . . . . . . . @ . . . . . . . @ . . . . . . . @ . . . . . . . @ . . . . . . . @ . . . . . . . @ . . . . . . . @ . . . . . . .
. . . . . . . . . . . . . . . . @ . . . . . . . @ . . . . . . . @ . . . . . . . @ . . . . . . . . . . . . . . . @ . . . . . . .
@ . . . . . . . @ . . . . . . . @ . . . . . . . @ . . . . . . . @ . . . . . . . . . . . . . . . @ . . . . . . . @ . . . . . . .
@ . . . . . . . @ . . . . . . . @ . . . . . . . @ . . . . . . . @ . . . . . . . @ . . . . . . . @ . . . . . . . . . . . . . . .
@ . . . . . . . @ . . . . . . . @ . . . . . . . @ . . . . . . . @ . . . . . . . @ . . . . . . . @ . . . . . . . @ . . . . . . .
@ @ @ @ @ @ @ . @ @ @ @ @ . @ @ @ @ @ @ @ @ @ @ @ @ @ @ @ @ . @ @ @ @ @ @ @ @ @ @ @ @ @ @ . @ @ @ @ @ @ @ @ @ . @ @ @ @ @ @ . @
@ . . . . . . . @ . . . . . . . @ . . . . . . . @ . . . . . . . @ . . . . . . . @ . . . . . . . @ . . . . . . . @ . . . . . . .
@ . . . . . . . @ . . . . . . . @ . . . . . . . @ . . . . . . . @ . . . . . . . . . . . . . . . @ . . . . . . . @ . . . . . . .
@ . . . . . . . @ . . . . . . . @ . . . . . . . @ . . . . . . . @ . . . . . . . @ . . . . . . . @ . . . . . . . @ . . . . . . .
. . . . . . . . @ . . . . . . . @ . . . . . . . . . . . . . . . @ . . . . . . . @ . . . . . . . . . . . . . . . @ . . . . . . .
@ . . . . . . . @ . . . . . . . @ . . . . . . . @ . . . . . . . @ . . . . . . . @ . . . . . . . @ . . . . . . . @ . . . . . . .
@ . . . . . . . . . . . . . . . @ . . . . . . . @ . . . . . . . @ . . . . . . . @ . . . . . . . @ . . . . . . . @ . . . . . . .
@ . . . . . . . @ . . . . . . . @ . . . . . . . @ . . . . . . . @ . . . . . . . @ . . . . . . . @ . . . . . . . @ . . . . . . .
@ . @ @ @ @ @ @ @ @ . @ @ @ @ @ @ @ @ @ @ . @ @ @ @ @ @ @ @ . @ @ @ @ @ @ @ . @ @ . @ @ @ @ @ @ @ . @ @ @ @ @ @ @ @ @ @ @ @ @ .
@ . . . . . . . . . . . . . . . @ . . . . . . . @ . . . . . . . @ . . . . . . . @ . . . . . . . @ . . . . . . . @ . . . . . . .
@ . . . . . . . @ . . . . . . . @ . . . . . . . @ . . . . . . . @ . . . . . . . @ . . . . . . . @ . . . . . . . @ . . . . . . .
@ . . . . . . . @ . . . . . . . @ . . . . . . . @ . . . . . . . . . . . . . . . @ . . . . . . . @ . . . . . . . @ . . . . . . .
@ . . . . . . . @ . . . . . . . @ . . . . . . . @ . . . . . . . @ . . . . . . . @ . . . . . . . @ . . . . . . . @ . . . . . . .
. . . . . . . . @ . . . . . . . @ . . . . . . . @ . . . . . . . @ . . . . . . . @ . . . . . . . @ . . . . . . . @ . . . . . . .
@ . . . . . . . @ . . . . . . . @ . . . . . . . @ . . . . . . . @ . . . . . . . @ . . . . . . . @ . . . . . . . . . . . . . . .
@ . . . . . . . @ . . . . . . . @ . . . . . . . . . . . . . . . @ . . . . . . . @ . . . . . . . @ . . . . . . . @ . . . . . . .
@ @ @ @ @ @ @ @ @ @ @ @ @ @ @ @ @ @ . @ @ @ @ @ @ @ @ . @ @ @ @ @ @ @ @ @ @ @ @ @ @ @ @ @ @ @ @ @ @ @ @ @ @ @ . @ @ . @ @ @ @ @
@ . . . . . . . @ . . . . . . . @ . . . . . . . @ . . . . . . . @ . . . . . . . @ . . . . . . . @ . . . . . . . @ . . . . . . .
@ . . . . . . . @ . . . . . . . @ . . . . . . . @ . . . . . . . . . . . . . . . @ . . . . . . . @ . . . . . . . @ . . . . . . .
@ . . . . . . . @ . . . . . . . @ . . . . . . . @ . . . . . . . @ . . . . . . . @ . . . . . . . @ . . . . . . . @ . . . . . . .
@ . . . . . . . . . . . . . . . @ . . . . . . . . . . . . . . . @ . . . . . . . @ . . . . . . . @ . . . . . . . @ . . . . . . .
@ . . . . . . . @ . . . . . . . @ . . . . . . . @ . . . . . . . @ . . . . . . . @ . . . . . . . @ . . . . . . . . . . . . . . .
. . . . . . . . @ . . . . . . . @ . . . . . . . @ . . . . . . . @ . . . . . . . . . . . . . . . @ . . . . . . . @ . . . . . . .
@ . . . . . . . @ . . . . . . . @ . . . . . . . @ . . . . . . . @ . . . . . . . @ . . . . . . . @ . . . . . . . @ . . . . . . .
@ @ @ @ @ @ @ . @ @ @ @ @ @ @ @ @ @ @ @ @ @ @ @ @ @ @ . @ @ @ @ @ @ . @ @ @ @ @ @ @ @ @ @ @ . @ @ @ @ @ . @ @ @ @ @ @ @ . @ @ @
@ . . . . . . . @ . . . . . . . @ . . . . . . . @ . . . . . . . @ . . . . . . . @ . . . . . . . . . . . . . . . @ . . . . . . .
@ . . . . . . . @ . . . . . . . @ . . . . . . . . . . . . . . . . . . . . . . . @ . . . . . . . @ . . . . . . . @ . . . . . . .
@ . . . . . . . @ . . . . . . . . . . . . . . . @ . . . . . . . @ . . . . . . . @ . . . . . . . @ . . . . . . . @ . . . . . . .
@ . . . . . . . @ . . . . . . . @ . . . . . . . @ . . . . . . . @ . . . . . . . @ . . . . . . . @ . . . . . . . @ . . . . . . .
@ . . . . . . . @ . . . . . . . @ . . . . . . . @ . . . . . . . @ . . . . . . . @ . . . . . . . @ . . . . . . . @ . . . . . . .
@ . . . . . . . . . . . . . . . @ . . . . . . . @ . . . . . . . @ . . . . . . . @ . . . . . . . @ . . . . . . . @ . . . . . . .
. . . . . . . . @ . . . . . . . @ . . . . . . . @ . . . . . . . @ . . . . . . . @ . . . . . . . @ . . . . . . . @ . . . . . . .
@ @ @ @ . @ @ @ @ . @ @ @ @ @ @ @ @ . @ @ @ @ @ @ @ @ @ @ @ . @ @ @ @ @ @ @ @ @ @ @ @ @ @ @ . @ @ @ @ @ @ @ @ @ @ @ @ @ @ @ @ @
. . . . . . . . @ . . . . . . . @ . . . . . . . @ . . . . . . . @ . . . . . . . @ . . . . . . . @ . . . . . . . @ . . . . . . .
@ . . . . . . . @ . . . . . . . @ . . . . . . . @ . . . . . . . @ . . . . . . . @ . . . . . . . @ . . . . . . . @ . . . . . . .
@ . . . . . . . @ . . . . . . . @ . . . . . . . @ . . . . . . . @ . . . . . . . @ . . . . . . . @ . . . . . . . @ . . . . . . .
@ . . . . . . . @ . . . . . . . @ . . . . . . . @ . . . . . . . @ . . . . . . . @ . . . . . . . @ . . . . . . . . . . . . . . .
@ . . . . . . . @ . . . . . . . @ . . . . . . . @ . . . . . . . @ . . . . . . . @ . . . . . . . @ . . . . . . . @ . . . . . . .
@ . . . . . . . @ . . . . . . . @ . . . . . . . @ . . . . . . . @ . . . . . . . @ . . . . . . . @ . . . . . . . @ . . . . . . .
@ . . . . . . . @ . . . . . . . . . . . . . . . . . . . . . . . . . . . . . . . . . . . . . . . @ . . . . . . . @ . . . . . . .
@ @ @ @ @ @ @ @ @ @ @ . @ @ @ @ @ @ @ @ @ @ @ @ @ @ @ @ @ @ @ . @ @ @ @ @ @ @ @ @ @ @ @ @ . @ @ @ @ @ @ @ @ @ . @ @ @ @ @ @ @ @
@ . . . . . . . @ . . . . . . . @ . . . . . . . @ . . . . . . . @ . . . . . . . @ . . . . . . . @ . . . . . . . @ . . . . . . .
@ . . . . . . . . . . . . . . . . . . . . . . . @ . . . . . . . @ . . . . . . . @ . . . . . . . @ . . . . . . . @ . . . . . . .
@ . . . . . . . @ . . . . . . . @ . . . . . . . . . . . . . . . @ . . . . . . . @ . . . . . . . . . . . . . . . . . . . . . . .
@ . . . . . . . @ . . . . . . . @ . . . . . . . @ . . . . . . . @ . . . . . . . @ . . . . . . . @ . . . . . . . @ . . . . . . .
@ . . . . . . . @ . . . . . . . @ . . . . . . . @ . . . . . . . @ . . . . . . . @ . . . . . . . @ . . . . . . . @ . . . . . . .
. . . . . . . . @ . . . . . . . @ . . . . . . . @ . . . . . . . @ . . . . . . . @ . . . . . . . @ . . . . . . . @ . . . . . . .
@ . . . . . . . @ . . . . . . . @ . . . . . . . @ . . . . . . . @ . . . . . . . . . . . . . . . @ . . . . . . . @ . . . . . . .
70
16 7 59 51
58 42 18 54
42 1 13 18
14 46 28 43
20 52 47 10
14 33 28 2
25 26 58 44
46 19 7 29
45 51 37 3
50 17 37 15
23 6 42 62
37 42 36 41
28 28 30 63
60 35 6 52
47 55 45 50
27 11 36 33
9 30 17 37
27 20 19 14
35 12 45 14
62 53 62 58
11 21 35 53
31 11 45 26
46 29 61 13
49 31 43 28
39 53 35 6
5 10 59 25
46 5 3 4
15 29 28 18
6 12 5 61
26 37 12 44
54 13 7 12
25 21 49 55
41 58 13 19
25 28 12 58
63 21 6 45
5 62 55 35
57 25 41 42
43 34 25 60
43 19 57 46
20 18 9 2
2 31 48 18
15 5 55 37
6 28 36 44
0 26 35 49
3 9 7 42
53 52 21 44
52 60 5 5
58 33 37 10
6 27 42 23
12 28 37 2
39 20 38 3
23 22 45 34
21 4 44 14
44 20 60 15
11 57 21 45
34 63 20 11
2 57 27 28
11 42 19 45
31 39 7 15
23 5 21 59
53 61 44 37
46 37 35 43
58 49 37 38
14 4 26 7
47 45 10 53
59 49 54 27
47 0 58 58
19 23 12 62
22 44 52 49
7 36 45 13
