64 64
@ @ @ . @ @ @ @ @ @ @ @ @ @ @ @ @ @ @ . @ @ @ @ @ @ . @ @ @ @ @ @ @ . @ @ @ @ @ @ @ @ @ @ @ @ @ @ . @ @ @ @ @ @ @ . @ @ @ @ @ @
@ . . . . . . . @ . . . . . . . @ . . . . . . . @ . . . . . . . @ . . . . . . . @ . . . . . . . @ . . . . . . . @ . . . . . . .
@ . . . . . . . @ . . . . . . . @ . . . . . . . @ . . . . . . . @ . . . . . . . @ . . . . . . . @ . . . . . . . @ . . . . . . .
. . . . . . . . @ . . . . . . . @ . . . . . . . @ . . . . . . . @ . . . . . . . @ . . . . . . . @ . . . . . . . @ . . . . . . .
@ . . . . . . . @ . . . . . . . @ . . . . . . . @ . . . . . . . @ . . . . . . . @ . . . . . . . @ . . . . . . . @ . . . . . . .
@ . . . . . . . . . . . . . . . . . . . . . . . @ . . . . . . . @ . . . . . . . @ . . . . . . . @ . . . . . . . . . . . . . . .
@ . . . . . . . @ . . . . . . . @ . . . . . . . @ . . . . . . . @ . . . . . . . @ . . . . . . . @ . . . . . . . @ . . . . . . .
@ . . . . . . . @ . . . . . . . @ . . . . . . . . . . . . . . . . . . . . . . . @ . . . . . . . . . . . . . . . @ . . . . . . .
@ . @ @ @ @ @ @ @ @ @ @ @ . @ @ @ @ @ @ @ . @ @ @ . @ @ @ @ @ @ @ . @ @ @ @ @ @ @ @ @ @ @ @ @ . @ @ @ @ @ @ . @ @ . @ @ @ @ @ @
@ . . . . . . . @ . . . . . . . @ . . . . . . . @ . . . . . . . @ . . . . . . . @ . . . . . . . @ . . . . . . . @ . . . . . . .
@ . . . . . . . @ . . . . . . . @ . . . . . . . . . . . . . . . . . . . . . . . @ . . . . . . . @ . . . . . . . @ . . . . . . .
@ . . . . . . . @ . . . . . . . @ . . . . . . . @ . . . . . . . @ . . . . . . . @ . . . . . . . @ . . . . . . . @ . . . . . . .
. . . . . . . . . . . . . . . . @ . . . . . . . @ . . . . . . . @ . . . . . . . @ . . . . . . . . . . . . . . . @ . . . . . . .
@ . . . . . . . @ . . . . . . . @ . . . . . . . @ . . . . . . . @ . . . . . . . . . . . . . . . @ . . . . . . . @ . . . . . . .
@ . . . . . . . @ . . . . . . . @ . . . . . . . @ . . . . . . . @ . . . . . . . @ . . . . . . . @ . . . . . . . . . . . . . . .
@ . . . . . . . @ . . . . . . . @ . . . . . . . @ . . . . . . . @ . . . . . . . @ . . . . . . . @ . . . . . . . @ . . . . . . .
@ @ @ @ @ @ @ . @ @ @ @ @ . @ @ @ @ @ @ @ @ @ @ @ @ @ @ @ @ . @ @ @ @ @ @ @ @ @ @ @ @ @ @ . @ @ @ @ @ @ @ @ @ . @ @ @ @ @ @ . @
@ . . . . . . . @ . . . . . . . @ . . . . . . . @ . . . . . . . @ . . . . . . . @ . . . . . . . @ . . . . . . . @ . . . . . . .
@ . . . . . . . @ . . . . . . . @ . . . . . . . @ . . . . . . . @ . . . . . . . . . . . . . . . @ . . . . . . . @ . . . . . . .
@ . . . . . . . @ . . . . . . . @ . . . . . . . @ . . . . . . . @ . . . . . . . @ . . . . . . . @ . . . . . . . @ . . . . . . .
. . . . . . . . @ . . . . . . . @ . . . . . . . . . . . . . . . @ . . . . . . . @ . . . . . . . . . . . . . . . @ . . . . . . .
@ . . . . . . . @ . . . . . . . @ . . . . . . . @ . . . . . . . @ . . . . . . . @ . . . . . . . @ . . . . . . . @ . . . . . . .
@ . . . . . . . . . . . . . . . @ . . . . . . . @ . . . . . . . @ . . . . . . . @ . . . . . . . @ . . . . . . . @ . . . . . . .
@ . . . . . . . @ . . . . . . . @ . . . . . . . @ . . . . . . . @ . . . . . . . @ . . . . . . . @ . . . . . . . @ . . . . . . .
@ . @ @ @ @ @ @ @ @ . @ @ @ @ @ @ @ @ @ @ . @ @ @ @ @ @ @ @ . @ @ @ @ @ @ @ . @ @ . @ @ @ @ @ @ @ . @ @ @ @ @ @ @ @ @ @ @ @ @ .
@ . . . . . . . . . . . . . . . @ . . . . . . . @ . . . . . . . @ . . . . . . . @ . . . . . . . @ . . . . . . . @ . . . . . . .
@ . . . . . . . @ . . . . . . . @ . . . . . . . @ . . . . . . . @ . . . . . . . @ . . . . . . . @ . . . . . . . @ . . . . . . .
@ . . . . . . . @ . . . . . . . @ . . . . . . . @ . . . . . . . . . . . . . . . @ . . . . . . . @ . . . . . . . @ . . . . . . .
@ . . . . . . . @ . . . . . . . @ . . . . . . . @ . . . . . . . @ . . . . . . . @ . . . . . . . @ . . . . . . . @ . . . . . . .
. . . . . . . . @ . . . . . . . @ . . . . . . . @ . . . . . . . @ . . . . . . . @ . . . . . . . @ . . . . . . . @ . . . . . . .
@ . . . . . . . @ . . . . . . . @ . . . . . . . @ . . . . . . . @ . . . . . . . @ . . . . . . . @ . . . . . . . . . . . . . . .
@ . . . . . . . @ . . . . . . . @ . . . . . . . . . . . . . . . @ . . . . . . . @ . . . . . . . @ . . . . . . . @ . . . . . . .
@ @ @ @ @ @ @ @ @ @ @ @ @ @ @ @ @ @ . @ @ @ @ @ @ @ @ . @ @ @ @ @ @ @ @ @ @ @ @ @ @ @ @ @ @ @ @ @ @ @ @ @ @ @ . @ @ . @ @ @ @ @
@ . . . . . . . @ . . . . . . . @ . . . . . . . @ . . . . . . . @ . . . . . . . @ . . . . . . . @ . . . . . . . @ . . . . . . .
@ . . . . . . . @ . . . . . . . @ . . . . . . . @ . . . . . . . . . . . . . . . @ . . . . . . . @ . . . . . . . @ . . . . . . .
@ . . . . . . . @ . . . . . . . @ . . . . . . . @ . . . . . . . @ . . . . . . . @ . . . . . . . @ . . . . . . . @ . . . . . . .
@ . . . . . . . . . . . . . . . @ . . . . . . . . . . . . . . . @ . . . . . . . @ . . . . . . . @ . . . . . . . @ . . . . . . .
@ . . . . . . . @ . . . . . . . @ . . . . . . . @ . . . . . . . @ . . . . . . . @ . . . . . . . @ . . . . . . . . . . . . . . .
. . . . . . . . @ . . . . . . . @ . . . . . . . @ . . . . . . . @ . . . . . . . . . . . . . . . @ . . . . . . . @ . . . . . . .
@ . . . . . . . @ . . . . . . . @ . . . . . . . @ . . . . . . . @ . . . . . . . @ . . . . . . . @ . . . . . . . @ . . . . . . .
@ @ @ @ @ @ @ . @ @ @ @ @ @ @ @ @ @ @ @ @ @ @ @ @ @ @ . @ @ @ @ @ @ . @ @ @ @ @ @ @ @ @ @ @ . @ @ @ @ @ . @ @ @ @ @ @ @ . @ @ @
@ . . . . . . . @ . . . . . . . @ . . . . . . . @ . . . . . . . @ . . . . . . . @ . . . . . . . . . . . . . . . @ . . . . . . .
@ . . . . . . . @ . . . . . . . @ . . . . . . . . . . . . . . . . . . . . . . . @ . . . . . . . @ . . . . . . . @ . . . . . . .
@ . . . . . . . @ . . . . . . . . . . . . . . . @ . . . . . . . @ . . . . . . . @ . . . . . . . @ . . . . . . . @ . . . . . . .
@ . . . . . . . @ . . . . . . . @ . . . . . . . @ . . . . . . . @ . . . . . . . @ . . . . . . . @ . . . . . . . @ . . . . . . .
@ . . . . . . . @ . . . . . . . @ . . . . . . . @ . . . . . . . @ . . . . . . . @ . . . . . . . @ . . . . . . . @ . . . . . . .
@ . . . . . . . . . . . . . . . @ . . . . . . . @ . . . . . . . @ . . . . . . . @ . . . . . . . @ . . . . . . . @ . . . . . . .
. . . . . . . . @ . . . . . . . @ . . . . . . . @ . . . . . . . @ . . . . . . . @ . . . . . . . @ . . . . . . . @ . . . . . . .
@ @ @ @ . @ @ @ @ . @ @ @ @ @ @ @ @ . @ @ @ @ @ @ @ @ @ @ @ . @ @ @ @ @ @ @ @ @ @ @ @ @ @ @ . @ @ @ @ @ @ @ @ @ @ @ @ @ @ @ @ @
. . . . . . . . @ . . . . . . . @ . . . . . . . @ . . . . . . . @ . . . . . . . @ . . . . . . . @ . . . . . . . @ . . . . . . .
@ . . . . . . . @ . . . . . . . @ . . . . . . . @ . . . . . . . @ . . . . . . . @ . . . . . . . @ . . . . . . . @ . . . . . . .
@ . . . . . . . @ . . . . . . . @ . . . . . . . @ . . . . . . . @ . . . . . . . @ . . . . . . . @ . . . . . . . @ . . . . . . .
@ . . . . . . . @ . . . . . . . @ . . . . . . . @ . . . . . . . @ . . . . . . . @ . . . . . . . @ . . . . . . . . . . . . . . .
@ . . . . . . . @ . . . . . . . @ . . . . . . . @ . . . . . . . @ . . . . . . . @ . . . . . . . @ . . . . . . . @ . . . . . . .
@ . . . . . . . @ . . . . . . . @ . . . . . . . @ . . . . . . . @ . . . . . . . @ . . . . . . . @ . . . . . . . @ . . . . . . .
@ . . . . . . . @ . . . . . . . . . . . . . . . . . . . . . . . . . . . . . . . . . . . . . . . @ . . . . . . . @ . . . . . . .
@ @ @ @ @ @ @ @ @ @ @ . @ @ @ @ @ @ @ @ @ @ @ @ @ @ @ @ @ @ @ . @ @ @ @ @ @ @ @ @ @ @ @ @ . @ @ @ @ @ @ @ @ @ . @ @ @ @ @ @ @ @
@ . . . . . . . @ . . . . . . . @ . . . . . . . @ . . . . . . . @ . . . . . . . @ . . . . . . . @ . . . . . . . @ . . . . . . .
@ . . . . . . . . . . . . . . . . . . . . . . . @ . . . . . . . @ . . . . . . . @ . . . . . . . @ . . . . . . . @ . . . . . . .
@ . . . . . . . @ . . . . . . . @ . . . . . . . . . . . . . . . @ . . . . . . . @ . . . . . . . . . . . . . . . . . . . . . . .
@ . . . . . . . @ . . . . . . . @ . . . . . . . @ . . . . . . . @ . . . . . . . @ . . . . . . . @ . . . . . . . @ . . . . . . .
@ . . . . . . . @ . . . . . . . @ . . . . . . . @ . . . . . . . @ . . . . . . . @ . . . . . . . @ . . . . . . . @ . . . . . . .
. . . . . . . . @ . . . . . . . @ . . . . . . . @ . . . . . . . @ . . . . . . . @ . . . . . . . @ . . . . . . . @ . . . . . . .
@ . . . . . . . @ . . . . . . . @ . . . . . . . @ . . . . . . . @ . . . . . . . . . . . . . . . @ . . . . . . . @ . . . . . . .
100
25 1 10 28
1 3 39 27
30 14 3 6
1 22 60 53
57 9 20 35
36 42 18 51
30 22 51 9
21 51 11 18
25 45 23 27
4 9 46 35
46 10 4 7
37 50 35 4
57 50 42 25
50 2 35 50
50 59 59 47
20 45 1 43
44 39 35 1
1 29 51 5
22 36 43 39
35 2 10 20
39 21 51 13
33 47 28 22
38 55 9 25
33 26 45 27
19 44 55 40
60 60 29 52
25 29 18 52
45 13 15 1
33 55 54 6
58 13 34 31
14 56 47 5
34 30 44 57
27 32 37 23
54 2 21 15
3 49 37 61
25 47 23 13
37 53 31 7
2 33 60 2
15 47 14 57
15 45 44 30
6 35 58 39
62 54 6 25
13 25 42 39
5 26 20 10
4 61 23 50
9 23 9 44
49 26 37 29
52 57 31 10
22 8 2 29
5 8 31 43
51 33 58 25
7 60 36 13
34 57 27 44
11 59 11 54
6 62 2 51
2 9 59 9
58 47 15 41
46 44 29 14
13 45 5 42
40 46 5 23
62 2 19 35
4 35 43 23
43 11 22 4
58 45 21 63
62 36 54 43
2 47 14 17
4 49 39 14
0 57 60 19
46 37 18 12
55 17 39 29
49 31 27 25
27 53 58 3
9 50 35 60
57 59 1 55
58 52 37 44
22 34 29 39
47 1 35 53
17 1 51 55
51 50 60 27
51 14 60 50
35 21 44 25
21 59 25 62
17 15 30 20
33 39 19 52
18 49 5 63
52 14 38 40
4 38 4 13
27 10 22 47
7 37 55 43
32 27 42 5
53 46 29 31
19 61 10 50
33 35 17 25
10 32 18 20
43 37 4 63
29 44 49 2
17 63 27 55
12 23 42 33
37 26 23 43
15 42 42 38
