64 64
@ @ @ . @ @ @ @ @ @ @ @ @ @ @ @ @ @ @ . @ @ @ @ @ @ . @ @ @ @ @ @ @ . @ @ @ @ @ @ @ @ @ @ @ @ @ @ . @ @ @ @ @ @ @ . @ @ @ @ @ @
@ . . . . . . . @ . . . . . . . @ . . . . . . . @ . . . . . . . @ . . . . . . . @ . . . . . . . @ . . . . . . . @ . . . . . . .
@ . . . . . . . @ . . . . . . . @ . . . . . . . @ . . . . . . . @ . . . . . . . @ . . . . . . . @ . . . . . . . @ . . . . . . .
. . . . . . . . @ . . . . . . . @ . . . . . . . @ . . . . . . . @ . . . . . . . @ . . . . . . . @ . . . . . . . @ . . . . . . .
@ . . . . . . . @ . . . . . . . @ . . . . . . . @ . . . . . . . @ . . . . . . . @ . . . . . . . @ . . . . . . . @ . . . . . . .
@ . . . . . . . . . . . . . . . . . . . . . . . @ . . . . . . . @ . . . . . . . @ . . . . . . . @ . . . . . . . . . . . . . . .
@ . . . . . . . @ . . . . . . . @ . . . . . . . @ . . . . . . . @ . . . . . . . @ . . . . . . . @ . . . . . . . @ . . . . . . .
@ . . . . . . . @ . . . . . . . @ . . . . . . . . . . . . . . . . . . . . . . . @ . . . . . . . . . . . . . . . @ . . . . . . .
@ . @ @ @ @ @ @ @ @ @ @ @ . @ @ @ @ @ @ @ . @ @ @ . @ @ @ @ @ @ @ . @ @ @ @ @ @ @ @ @ @ @ @ @ . @ @ @ @ @ @ . @ @ . @ @ @ @ @ @
@ . . . . . . . @ . . . . . . . @ . . . . . . . @ . . . . . . . @ . . . . . . . @ . . . . . . . @ . . . . . . . @ . . . . . . .
@ . . . . . . . @ . . . . . . . @ . . . . . . . . . . . . . . . . . . . . . . . @ . . . . . . . @ . . . . . . . @ . . . . . . .
@ . . . . . . . @ . . . . . . . @ . . . . . . . @ . . . . . . . @ . . . . . . . @ . . . . . . . @ . . . . . . . @ . . . . . . .
. . . . . . . . . . . . . . . . @ . . . . . . . @ . . . . . . . @ . . . . . . . @ . . . . . . . . . . . . . . . @ . . . . . . .
@ . . . . . . . @ . . . . . . . @ . . . . . . . @ . . . . . . . @ . . . . . . . . . . . . . . . @ . . . . . . . @ . . . . . . .
@ . . . . . . . @ . . . . . . . @ . . . . . . . @ . . . . . . . @ . . . . . . . @ . . . . . . . @ . . . . . . . . . . . . . . .
@ . . . . . . . @ . . . . . . . @ . . . . . . . @ . . . . . . . @ . . . . . . . @ . . . . . . . @ . . . . . . . @ . . . . . . .
@ @ @ @ @ @ @ . @ @ @ @ @ . @ @ @ @ @ @ @ @ @ @ @ @ @ @ @ @ . @ @ @ @ @ @ @ @ @ @ @ @ @ @ . @ @ @ @ @ @ @ @ @ . @ @ @ @ @ @ . @
@ . . . . . . . @ . . . . . . . @ . . . . . . . @ . . . . . . . @ . . . . . . . @ . . . . . . . @ . . . . . . . @ . . . . . . .
@ . . . . . . . @ . . . . . . . @ . . . . . . . @ . . . . . . . @ . . . . . . . . . . . . . . . @ . . . . . . . @ . . . . . . .
@ . . . . . . . @ . . . . . . . @ . . . . . . . @ . . . . . . . @ . . . . . . . @ . . . . . . . @ . . . . . . . @ . . . . . . .
. . . . . . . . @ . . . . . . . @ . . . . . . . . . . . . . . . @ . . . . . . . @ . . . . . . . . . . . . . . . @ . . . . . . .
@ . . . . . . . @ . . . . . . . @ . . . . . . . @ . . . . . . . @ . . . . . . . @ . . . . . . . @ . . . . . . . @ . . . . . . .
@ . . . . . . . . . . . . . . . @ . . . . . . . @ . . . . . . . @ . . . . . . . @ . . . . . . . @ . . . . . . . @ . . . . . . .
@ . . . . . . . @ . . . . . . . @ . . . . . . . @ . . . . . . . @ . . . . . . . @ . . . . . . . @ . . . . . . . @ . . . . . . .
@ . @ @ @ @ @ @ @ @ . @ @ @ @ @ @ @ @ @ @ . @ @ @ @ @ @ @ @ . @ @ @ @ @ @ @ . @ @ . @ @ @ @ @ @ @ . @ @ @ @ @ @ @ @ @ @ @ @ @ .
@ . . . . . . . . . . . . . . . @ . . . . . . . @ . . . . . . . @ . . . . . . . @ . . . . . . . @ . . . . . . . @ . . . . . . .
@ . . . . . . . @ . . . . . . . @ . . . . . . . @ . . . . . . . @ . . . . . . . @ . . . . . . . @ . . . . . . . @ . . . . . . .
@ . . . . . . . @ . . . . . . . @ . . . . . . . @ . . . . . . . . . . . . . . . @ . . . . . . . @ . . . . . . . @ . . . . . . .
@ . . . . . . . @ . . . . . . . @ . . . . . . . @ . . . . . . . @ . . . . . . . @ . . . . . . . @ . . . . . . . @ . . . . . . .
. . . . . . . . @ . . . . . . . @ . . . . . . . @ . . . . . . . @ . . . . . . . @ . . . . . . . @ . . . . . . . @ . . . . . . .
@ . . . . . . . @ . . . . . . . @ . . . . . . . @ . . . . . . . @ . . . . . . . @ . . . . . . . @ . . . . . . . . . . . . . . .
@ . . . . . . . @ . . . . . . . @ . . . . . . . . . . . . . . . @ . . . . . . . @ . . . . . . . @ . . . . . . . @ . . . . . . .
@ @ @ @ @ @ @ @ @ @ @ @ @ @ @ @ @ @ . @ @ @ @ @ @ @ @ . @ @ @ @ @ @ @ @ @ @ @ @ @ @ @ @ @ @ @ @ @ @ @ @ @ @ @ . @ @ . @ @ @ @ @
@ . . . . . . . @ . . . . . . . @ . . . . . . . @ . . . . . . . @ . . . . . . . @ . . . . . . . @ . . . . . . . @ . . . . . . .
@ . . . . . . . @ . . . . . . . @ . . . . . . . @ . . . . . . . . . . . . . . . @ . . . . . . . @ . . . . . . . @ . . . . . . .
@ . . . . . . . @ . . . . . . . @ . . . . . . . @ . . . . . . . @ . . . . . . . @ . . . . . . . @ . . . . . . . @ . . . . . . .
@ . . . . . . . . . . . . . . . @ . . . . . . . . . . . . . . . @ . . . . . . . @ . . . . . . . @ . . . . . . . @ . . . . . . .
@ . . . . . . . @ . . . . . . . @ . . . . . . . @ . . . . . . . @ . . . . . . . @ . . . . . . . @ . . . . . . . . . . . . . . .
. . . . . . . . @ . . . . . . . @ . . . . . . . @ . . . . . . . @ . . . . . . . . . . . . . . . @ . . . . . . . @ . . . . . . .
@ . . . . . . . @ . . . . . . . @ . . . . . . . @ . . . . . . . @ . . . . . . . @ . . . . . . . @ . . . . . . . @ . . . . . . .
@ @ @ @ @ @ @ . @ @ @ @ @ @ @ @ @ @ @ @ @ @ @ @ @ @ @ . @ @ @ @ @ @ . @ @ @ @ @ @ @ @ @ @ @ . @ @ @ @ @ . @ @ @ @ @ @ @ . @ @ @
@ . . . . . . . @ . . . . . . . @ . . . . . . . @ . . . . . . . @ . . . . . . . @ . . . . . . . . . . . . . . . @ . . . . . . .
@ . . . . . . . @ . . . . . . . @ . . . . . . . . . . . . . . . . . . . . . . . @ . . . . . . . @ . . . . . . . @ . . . . . . .
@ . . . . . . . @ . . . . . . . . . . . . . . . @ . . . . . . . @ . . . . . . . @ . . . . . . . @ . . . . . . . @ . . . . . . .
@ . . . . . . . @ . . . . . . . @ . . . . . . . @ . . . . . . . @ . . . . . . . @ . . . . . . . @ . . . . . . . @ . . . . . . .
@ . . . . . . . @ . . . . . . . @ . . . . . . . @ . . . . . . . @ . . . . . . . @ . . . . . . . @ . . . . . . . @ . . . . . . .
@ . . . . . . . . . . . . . . . @ . . . . . . . @ . . . . . . . @ . . . . . . . @ . . . . . . . @ . . . . . . . @ . . . . . . .
. . . . . . . . @ . . . . . . . @ . . . . . . . @ . . . . . . . @ . . . . . . . @ . . . . . . . @ . . . . . . . @ . . . . . . .
@ @ @ @ . @ @ @ @ . @ @ @ @ @ @ @ @ . @ @ @ @ @ @ @ @ @ @ @ . @ @ @ @ @ @ @ @ @ @ @ @ @ @ @ . @ @ @ @ @ @ @ @ @ @ @ @ @ @ @ @ @
. . . . . . . . @ . . . . . . . @ . . . . . . . @ . . . . . . . @ . . . . . . . @ . . . . . . . @ . . . . . . . @ . . . . . . .
@ . . . . . . . @ . . . . . . . @ . . . . . . . @ . . . . . . . @ . . . . . . . @ . . . . . . . @ . . . . . . . @ . . . . . . .
@ . . . . . . . @ . . . . . . . @ . . . . . . . @ . . . . . . . @ . . . . . . . @ . . . . . . . @ . . . . . . . @ . . . . . . .
@ . . . . . . . @ . . . . . . . @ . . . . . . . @ . . . . . . . @ . . . . . . . @ . . . . . . . @ . . . . . . . . . . . . . . .
@ . . . . . . . @ . . . . . . . @ . . . . . . . @ . . . . . . . @ . . . . . . . @ . . . . . . . @ . . . . . . . @ . . . . . . .
@ . . . . . . . @ . . . . . . . @ . . . . . . . @ . . . . . . . @ . . . . . . . @ . . . . . . . @ . . . . . . . @ . . . . . . .
@ . . . . . . . @ . . . . . . . . . . . . . . . . . . . . . . . . . . . . . . . . . . . . . . . @ . . . . . . . @ . . . . . . .
@ @ @ @ @ @ @ @ @ @ @ . @ @ @ @ @ @ @ @ @ @ @ @ @ @ @ @ @ @ @ . @ @ @ @ @ @ @ @ @ @ @ @ @ . @ @ @ @ @ @ @ @ @ . @ @ @ @ @ @ @ @
@ . . . . . . . @ . . . . . . . @ . . . . . . . @ . . . . . . . @ . . . . . . . @ . . . . . . . @ . . . . . . . @ . . . . . . .
@ . . . . . . . . . . . . . . . . . . . . . . . @ . . . . . . . @ . . . . . . . @ . . . . . . . @ . . . . . . . @ . . . . . . .
@ . . . . . . . @ . . . . . . . @ . . . . . . . . . . . . . . . @ . . . . . . . @ . . . . . . . . . . . . . . . . . . . . . . .
@ . . . . . . . @ . . . . . . . @ . . . . . . . @ . . . . . . . @ . . . . . . . @ . . . . . . . @ . . . . . . . @ . . . . . . .
@ . . . . . . . @ . . . . . . . @ . . . . . . . @ . . . . . . . @ . . . . . . . @ . . . . . . . @ . . . . . . . @ . . . . . . .
. . . . . . . . @ . . . . . . . @ . . . . . . . @ . . . . . . . @ . . . . . . . @ . . . . . . . @ . . . . . . . @ . . . . . . .
@ . . . . . . . @ . . . . . . . @ . . . . . . . @ . . . . . . . @ . . . . . . . . . . . . . . . @ . . . . . . . @ . . . . . . .
120
19 12 30 42
22 31 45 58
45 17 62 39
4 44 62 30
49 11 21 35
49 1 43 60
30 59 46 53
21 30 49 39
61 57 13 46
46 36 61 10
4 51 54 50
10 55 22 26
51 9 26 15
41 11 44 42
54 10 27 44
57 28 6 27
20 3 27 20
10 5 62 21
59 60 13 50
44 20 52 51
26 42 52 21
41 23 3 15
36 36 26 18
21 51 47 27
6 55 47 45
51 50 13 4
13 39 5 29
37 31 28 5
27 11 30 10
34 50 63 29
51 57 39 58
30 11 14 51
22 63 55 34
2 44 30 30
51 22 42 20
43 54 21 26
34 49 58 16
37 22 28 60
3 11 58 6
10 24 22 9
37 44 63 21
6 21 51 12
11 60 26 30
2 25 57 18
21 12 14 9
47 49 33 51
43 52 49 27
11 36 19 43
2 42 20 41
6 18 31 12
39 4 63 17
59 21 20 19
51 49 14 3
59 42 37 2
22 7 33 27
22 39 3 34
21 19 36 54
17 11 50 37
36 14 59 14
2 37 13 31
30 28 47 50
7 2 17 36
50 7 23 53
14 30 3 0
34 3 25 12
21 31 20 44
11 21 31 47
12 12 49 59
52 58 23 43
57 62 6 22
50 10 3 7
41 33 30 9
11 41 37 52
12 48 31 53
55 50 31 28
22 15 17 44
53 22 23 46
15 12 21 37
14 44 63 44
42 61 2 58
45 12 28 4
56 45 14 6
39 19 60 54
41 26 7 52
34 33 46 57
9 42 53 12
39 39 42 9
26 20 22 59
16 7 10 31
51 31 60 35
29 15 60 6
3 31 3 12
43 6 62 2
27 45 3 35
57 20 59 22
8 47 27 19
25 10 26 49
3 57 43 47
38 15 34 47
10 49 55 20
23 9 11 59
17 27 1 39
47 30 18 55
19 14 57 1
60 63 5 1
1 23 28 20
33 62 39 14
38 54 19 2
41 13 18 13
7 48 26 55
11 45 11 13
26 44 15 17
9 38 18 19
28 6 5 43
43 3 59 15
14 17 61 7
52 56 53 55
50 26 42 18
12 58 30 33
28 11 5 41
