32 32
@ @ @ @ @ @ @ @ @ @ @ @ @ @ @ @ @ @ @ @ @ @ @ @ @ @ @ @ @ @ @ @
@ . . @ . . @ . . . . . . . . . . . . . . . . . . . . . . . . .
@ . . @ . . @ . . . . . . . . . . . . . . . . . . . . . . . . .
@ . . @ . . @ . . @ @ @ @ @ @ @ @ @ @ @ @ @ . . @ @ @ @ . . @ .
@ . . . . . @ . . . . . . . . . . . . . . @ . . @ . . @ . . @ .
@ . . . . . @ . . . . . . . . . . . . . . @ . . @ . . @ . . @ .
@ . . @ @ @ @ @ @ @ . . @ @ @ @ @ @ @ @ @ @ . . @ . . @ @ @ @ .
@ . . . . . . . . . . . @ . . . . . . . . . . . @ . . . . . @ .
@ . . . . . . . . . . . @ . . . . . . . . . . . @ . . . . . @ .
@ @ @ @ @ @ @ @ @ @ @ @ @ . . @ @ @ @ . . @ @ @ @ . . @ @ @ @ @
@ . . . . . . . . . . . . . . @ . . . . . @ . . @ . . @ . . . .
@ . . . . . . . . . . . . . . @ . . . . . @ . . @ . . @ . . . .
@ . . @ @ @ @ @ @ @ @ @ @ @ @ @ @ @ @ @ @ @ . . @ . . @ @ @ @ .
@ . . . . . . . . . . . . . . @ . . . . . @ . . . . . @ . . . .
@ . . . . . . . . . . . . . . @ . . . . . @ . . . . . @ . . . .
@ . . @ @ @ @ @ @ @ . . @ @ @ @ . . @ . . @ @ @ @ . . @ . . @ @
@ . . @ . . . . . . . . @ . . . . . @ . . . . . . . . @ . . @ .
@ . . @ . . . . . . . . @ . . . . . @ . . . . . . . . @ . . @ .
@ @ @ @ . . @ @ @ @ . . @ . . @ @ @ @ . . @ @ @ @ @ @ @ . . @ .
@ . . . . . @ . . . . . @ . . @ . . . . . @ . . . . . . . . @ .
@ . . . . . @ . . . . . @ . . @ . . . . . @ . . . . . . . . @ .
@ . . @ . . @ @ @ @ @ @ @ . . @ . . @ @ @ @ . . @ @ @ @ @ @ @ .
@ . . @ . . . . . . . . @ . . @ . . @ . . @ . . @ . . . . . . .
@ . . @ . . . . . . . . @ . . @ . . @ . . @ . . @ . . . . . . .
@ . . @ @ @ @ . . @ @ @ @ . . @ @ @ @ . . @ . . @ @ @ @ @ @ @ .
@ . . @ . . @ . . . . . . . . . . . . . . . . . @ . . . . . . .
@ . . @ . . @ . . . . . . . . . . . . . . . . . @ . . . . . . .
@ . . @ . . @ @ @ @ @ @ @ @ @ @ . . @ @ @ @ @ @ @ . . @ @ @ @ .
@ . . @ . . @ . . . . . . . . @ . . @ . . . . . . . . @ . . @ .
@ . . @ . . @ . . . . . . . . @ . . @ . . . . . . . . @ . . @ .
@ . . @ . . @ @ @ @ . . @ . . @ . . @ @ @ @ . . @ @ @ @ . . @ .
@ . . . . . @ . . . . . @ . . . . . . . . . . . @ . . . . . . .
30
31 4 1 9
28 16 9 26
14 28 4 23
30 23 2 22
23 28 20 18
13 4 6 23
1 26 2 16
2 20 14 10
16 9 2 2
14 29 10 23
10 8 24 7
7 25 31 13
13 3 31 20
15 19 1 31
17 6 31 22
2 1 5 14
18 20 16 24
26 31 10 4
13 18 28 20
8 25 7 2
19 11 8 15
29 16 23 27
25 1 23 16
31 9 29 19
26 28 26 1
14 9 5 26
15 10 26 13
25 31 31 3
31 18 22 10
5 10 4 14
