32 32
@ @ @ @ @ @ @ @ @ @ @ @ @ @ @ @ @ @ @ @ @ @ @ @ @ @ @ @ @ @ @ @
@ . . @ . . @ . . . . . . . . . . . . . . . . . . . . . . . . .
@ . . @ . . @ . . . . . . . . . . . . . . . . . . . . . . . . .
@ . . @ . . @ . . @ @ @ @ @ @ @ @ @ @ @ @ @ . . @ @ @ @ . . @ .
@ . . . . . @ . . . . . . . . . . . . . . @ . . @ . . @ . . @ .
@ . . . . . @ . . . . . . . . . . . . . . @ . . @ . . @ . . @ .
@ . . @ @ @ @ @ @ @ . . @ @ @ @ @ @ @ @ @ @ . . @ . . @ @ @ @ .
@ . . . . . . . . . . . @ . . . . . . . . . . . @ . . . . . @ .
@ . . . . . . . . . . . @ . . . . . . . . . . . @ . . . . . @ .
@ @ @ @ @ @ @ @ @ @ @ @ @ . . @ @ @ @ . . @ @ @ @ . . @ @ @ @ @
@ . . . . . . . . . . . . . . @ . . . . . @ . . @ . . @ . . . .
@ . . . . . . . . . . . . . . @ . . . . . @ . . @ . . @ . . . .
@ . . @ @ @ @ @ @ @ @ @ @ @ @ @ @ @ @ @ @ @ . . @ . . @ @ @ @ .
@ . . . . . . . . . . . . . . @ . . . . . @ . . . . . @ . . . .
@ . . . . . . . . . . . . . . @ . . . . . @ . . . . . @ . . . .
@ . . @ @ @ @ @ @ @ . . @ @ @ @ . . @ . . @ @ @ @ . . @ . . @ @
@ . . @ . . . . . . . . @ . . . . . @ . . . . . . . . @ . . @ .
@ . . @ . . . . . . . . @ . . . . . @ . . . . . . . . @ . . @ .
@ @ @ @ . . @ @ @ @ . . @ . . @ @ @ @ . . @ @ @ @ @ @ @ . . @ .
@ . . . . . @ . . . . . @ . . @ . . . . . @ . . . . . . . . @ .
@ . . . . . @ . . . . . @ . . @ . . . . . @ . . . . . . . . @ .
@ . . @ . . @ @ @ @ @ @ @ . . @ . . @ @ @ @ . . @ @ @ @ @ @ @ .
@ . . @ . . . . . . . . @ . . @ . . @ . . @ . . @ . . . . . . .
@ . . @ . . . . . . . . @ . . @ . . @ . . @ . . @ . . . . . . .
@ . . @ @ @ @ . . @ @ @ @ . . @ @ @ @ . . @ . . @ @ @ @ @ @ @ .
@ . . @ . . @ . . . . . . . . . . . . . . . . . @ . . . . . . .
@ . . @ . . @ . . . . . . . . . . . . . . . . . @ . . . . . . .
@ . . @ . . @ @ @ @ @ @ @ @ @ @ . . @ @ @ @ @ @ @ . . @ @ @ @ .
@ . . @ . . @ . . . . . . . . @ . . @ . . . . . . . . @ . . @ .
@ . . @ . . @ . . . . . . . . @ . . @ . . . . . . . . @ . . @ .
@ . . @ . . @ @ @ @ . . @ . . @ . . @ @ @ @ . . @ @ @ @ . . @ .
@ . . . . . @ . . . . . @ . . . . . . . . . . . @ . . . . . . .
50
16 29 19 31
22 10 23 28
1 16 10 17
4 17 1 20
14 18 23 13
17 4 10 7
25 20 25 28
29 11 31 8
22 29 14 7
8 10 19 8
7 13 11 26
7 7 28 24
28 20 2 2
31 30 11 16
31 13 25 18
31 15 15 28
26 27 20 13
27 25 30 13
3 5 26 18
16 31 25 13
19 3 6 31
15 17 4 25
14 24 13 3
24 31 31 27
18 5 13 4
13 16 26 13
16 4 10 16
31 18 23 20
18 13 2 25
16 13 5 19
18 19 13 10
30 10 8 21
4 7 25 30
29 20 17 19
19 11 31 25
24 22 26 26
1 15 2 31
10 11 23 22
29 26 11 2
22 1 4 3
2 27 10 22
9 20 21 31
31 31 21 16
29 12 7 27
8 29 15 20
15 2 11 10
8 28 11 20
29 23 17 1
19 27 3 29
21 4 16 21
