32 32
@ @ @ @ @ @ @ @ @ @ @ @ @ @ @ @ @ @ @ @ @ @ @ @ @ @ @ @ @ @ @ @
@ . . @ . . @ . . . . . . . . . . . . . . . . . . . . . . . . .
@ . . @ . . @ . . . . . . . . . . . . . . . . . . . . . . . . .
@ . . @ . . @ . . @ @ @ @ @ @ @ @ @ @ @ @ @ . . @ @ @ @ . . @ .
@ . . . . . @ . . . . . . . . . . . . . . @ . . @ . . @ . . @ .
@ . . . . . @ . . . . . . . . . . . . . . @ . . @ . . @ . . @ .
@ . . @ @ @ @ @ @ @ . . @ @ @ @ @ @ @ @ @ @ . . @ . . @ @ @ @ .
@ . . . . . . . . . . . @ . . . . . . . . . . . @ . . . . . @ .
@ . . . . . . . . . . . @ . . . . . . . . . . . @ . . . . . @ .
@ @ @ @ @ @ @ @ @ @ @ @ @ . . @ @ @ @ . . @ @ @ @ . . @ @ @ @ @
@ . . . . . . . . . . . . . . @ . . . . . @ . . @ . . @ . . . .
@ . . . . . . . . . . . . . . @ . . . . . @ . . @ . . @ . . . .
@ . . @ @ @ @ @ @ @ @ @ @ @ @ @ @ @ @ @ @ @ . . @ . . @ @ @ @ .
@ . . . . . . . . . . . . . . @ . . . . . @ . . . . . @ . . . .
@ . . . . . . . . . . . . . . @ . . . . . @ . . . . . @ . . . .
@ . . @ @ @ @ @ @ @ . . @ @ @ @ . . @ . . @ @ @ @ . . @ . . @ @
@ . . @ . . . . . . . . @ . . . . . @ . . . . . . . . @ . . @ .
@ . . @ . . . . . . . . @ . . . . . @ . . . . . . . . @ . . @ .
@ @ @ @ . . @ @ @ @ . . @ . . @ @ @ @ . . @ @ @ @ @ @ @ . . @ .
@ . . . . . @ . . . . . @ . . @ . . . . . @ . . . . . . . . @ .
@ . . . . . @ . . . . . @ . . @ . . . . . @ . . . . . . . . @ .
@ . . @ . . @ @ @ @ @ @ @ . . @ . . @ @ @ @ . . @ @ @ @ @ @ @ .
@ . . @ . . . . . . . . @ . . @ . . @ . . @ . . @ . . . . . . .
@ . . @ . . . . . . . . @ . . @ . . @ . . @ . . @ . . . . . . .
@ . . @ @ @ @ . . @ @ @ @ . . @ @ @ @ . . @ . . @ @ @ @ @ @ @ .
@ . . @ . . @ . . . . . . . . . . . . . . . . . @ . . . . . . .
@ . . @ . . @ . . . . . . . . . . . . . . . . . @ . . . . . . .
@ . . @ . . @ @ @ @ @ @ @ @ @ @ . . @ @ @ @ @ @ @ . . @ @ @ @ .
@ . . @ . . @ . . . . . . . . @ . . @ . . . . . . . . @ . . @ .
@ . . @ . . @ . . . . . . . . @ . . @ . . . . . . . . @ . . @ .
@ . . @ . . @ @ @ @ . . @ . . @ . . @ @ @ @ . . @ @ @ @ . . @ .
@ . . . . . @ . . . . . @ . . . . . . . . . . . @ . . . . . . .
20
2 23 20 19
4 25 4 15
29 4 3 1
7 29 7 13
23 22 10 9
4 23 18 13
20 17 3 8
8 21 22 8
28 23 13 7
4 26 16 16
31 27 4 7
24 7 24 1
2 30 24 23
22 11 1 2
28 21 30 14
21 14 8 7
31 1 16 26
28 14 14 7
11 20 26 13
29 26 29 10
