32 32
@ @ @ @ @ @ @ @ @ @ @ @ @ @ @ @ @ @ @ @ @ @ @ @ @ @ @ @ @ @ @ @
@ . . @ . . @ . . . . . . . . . . . . . . . . . . . . . . . . .
@ . . @ . . @ . . . . . . . . . . . . . . . . . . . . . . . . .
@ . . @ . . @ . . @ @ @ @ @ @ @ @ @ @ @ @ @ . . @ @ @ @ . . @ .
@ . . . . . @ . . . . . . . . . . . . . . @ . . @ . . @ . . @ .
@ . . . . . @ . . . . . . . . . . . . . . @ . . @ . . @ . . @ .
@ . . @ @ @ @ @ @ @ . . @ @ @ @ @ @ @ @ @ @ . . @ . . @ @ @ @ .
@ . . . . . . . . . . . @ . . . . . . . . . . . @ . . . . . @ .
@ . . . . . . . . . . . @ . . . . . . . . . . . @ . . . . . @ .
@ @ @ @ @ @ @ @ @ @ @ @ @ . . @ @ @ @ . . @ @ @ @ . . @ @ @ @ @
@ . . . . . . . . . . . . . . @ . . . . . @ . . @ . . @ . . . .
@ . . . . . . . . . . . . . . @ . . . . . @ . . @ . . @ . . . .
@ . . @ @ @ @ @ @ @ @ @ @ @ @ @ @ @ @ @ @ @ . . @ . . @ @ @ @ .
@ . . . . . . . . . . . . . . @ . . . . . @ . . . . . @ . . . .
@ . . . . . . . . . . . . . . @ . . . . . @ . . . . . @ . . . .
@ . . @ @ @ @ @ @ @ . . @ @ @ @ . . @ . . @ @ @ @ . . @ . . @ @
@ . . @ . . . . . . . . @ . . . . . @ . . . . . . . . @ . . @ .
@ . . @ . . . . . . . . @ . . . . . @ . . . . . . . . @ . . @ .
@ @ @ @ . . @ @ @ @ . . @ . . @ @ @ @ . . @ @ @ @ @ @ @ . . @ .
@ . . . . . @ . . . . . @ . . @ . . . . . @ . . . . . . . . @ .
@ . . . . . @ . . . . . @ . . @ . . . . . @ . . . . . . . . @ .
@ . . @ . . @ @ @ @ @ @ @ . . @ . . @ @ @ @ . . @ @ @ @ @ @ @ .
@ . . @ . . . . . . . . @ . . @ . . @ . . @ . . @ . . . . . . .
@ . . @ . . . . . . . . @ . . @ . . @ . . @ . . @ . . . . . . .
@ . . @ @ @ @ . . @ @ @ @ . . @ @ @ @ . . @ . . @ @ @ @ @ @ @ .
@ . . @ . . @ . . . . . . . . . . . . . . . . . @ . . . . . . .
@ . . @ . . @ . . . . . . . . . . . . . . . . . @ . . . . . . .
@ . . @ . . @ @ @ @ @ @ @ @ @ @ . . @ @ @ @ @ @ @ . . @ @ @ @ .
@ . . @ . . @ . . . . . . . . @ . . @ . . . . . . . . @ . . @ .
@ . . @ . . @ . . . . . . . . @ . . @ . . . . . . . . @ . . @ .
@ . . @ . . @ @ @ @ . . @ . . @ . . @ @ @ @ . . @ @ @ @ . . @ .
@ . . . . . @ . . . . . @ . . . . . . . . . . . @ . . . . . . .
60
20 9 1 28
29 12 10 29
10 2 29 19
5 17 16 1
30 13 11 30
31 2 5 2
22 4 22 30
14 30 28 20
18 19 10 18
18 11 30 31
29 7 8 7
7 19 1 19
2 9 11 19
22 29 14 10
21 17 13 6
1 16 14 29
26 25 14 6
11 7 19 5
8 23 28 26
19 28 2 17
2 11 30 22
29 22 11 26
3 22 27 2
16 13 26 22
15 2 16 21
9 14 21 4
17 4 1 24
3 4 14 31
10 13 19 11
23 17 5 19
8 1 13 4
2 21 11 1
7 4 9 20
13 2 28 2
25 23 29 28
11 22 16 26
22 11 18 29
25 29 24 23
30 1 14 3
23 1 11 6
7 20 28 13
2 30 16 25
5 22 13 8
2 23 28 11
18 10 31 7
14 25 1 10
10 6 27 17
29 26 13 10
26 2 23 6
26 27 20 31
17 5 26 9
5 26 4 7
5 18 4 5
13 29 11 20
19 25 23 2
24 31 2 16
19 13 31 29
4 15 7 17
16 9 7 31
29 5 31 18
