32 32
@ @ @ @ @ @ @ @ @ @ @ @ @ @ @ @ @ @ @ @ @ @ @ @ @ @ @ @ @ @ @ @
@ . . @ . . @ . . . . . . . . . . . . . . . . . . . . . . . . .
@ . . @ . . @ . . . . . . . . . . . . . . . . . . . . . . . . .
@ . . @ . . @ . . @ @ @ @ @ @ @ @ @ @ @ @ @ . . @ @ @ @ . . @ .
@ . . . . . @ . . . . . . . . . . . . . . @ . . @ . . @ . . @ .
@ . . . . . @ . . . . . . . . . . . . . . @ . . @ . . @ . . @ .
@ . . @ @ @ @ @ @ @ . . @ @ @ @ @ @ @ @ @ @ . . @ . . @ @ @ @ .
@ . . . . . . . . . . . @ . . . . . . . . . . . @ . . . . . @ .
@ . . . . . . . . . . . @ . . . . . . . . . . . @ . . . . . @ .
@ @ @ @ @ @ @ @ @ @ @ @ @ . . @ @ @ @ . . @ @ @ @ . . @ @ @ @ @
@ . . . . . . . . . . . . . . @ . . . . . @ . . @ . . @ . . . .
@ . . . . . . . . . . . . . . @ . . . . . @ . . @ . . @ . . . .
@ . . @ @ @ @ @ @ @ @ @ @ @ @ @ @ @ @ @ @ @ . . @ . . @ @ @ @ .
@ . . . . . . . . . . . . . . @ . . . . . @ . . . . . @ . . . .
@ . . . . . . . . . . . . . . @ . . . . . @ . . . . . @ . . . .
@ . . @ @ @ @ @ @ @ . . @ @ @ @ . . @ . . @ @ @ @ . . @ . . @ @
@ . . @ . . . . . . . . @ . . . . . @ . . . . . . . . @ . . @ .
@ . . @ . . . . . . . . @ . . . . . @ . . . . . . . . @ . . @ .
@ @ @ @ . . @ @ @ @ . . @ . . @ @ @ @ . . @ @ @ @ @ @ @ . . @ .
@ . . . . . @ . . . . . @ . . @ . . . . . @ . . . . . . . . @ .
@ . . . . . @ . . . . . @ . . @ . . . . . @ . . . . . . . . @ .
@ . . @ . . @ @ @ @ @ @ @ . . @ . . @ @ @ @ . . @ @ @ @ @ @ @ .
@ . . @ . . . . . . . . @ . . @ . . @ . . @ . . @ . . . . . . .
@ . . @ . . . . . . . . @ . . @ . . @ . . @ . . @ . . . . . . .
@ . . @ @ @ @ . . @ @ @ @ . . @ @ @ @ . . @ . . @ @ @ @ @ @ @ .
@ . . @ . . @ . . . . . . . . . . . . . . . . . @ . . . . . . .
@ . . @ . . @ . . . . . . . . . . . . . . . . . @ . . . . . . .
@ . . @ . . @ @ @ @ @ @ @ @ @ @ . . @ @ @ @ @ @ @ . . @ @ @ @ .
@ . . @ . . @ . . . . . . . . @ . . @ . . . . . . . . @ . . @ .
@ . . @ . . @ . . . . . . . . @ . . @ . . . . . . . . @ . . @ .
@ . . @ . . @ @ @ @ . . @ . . @ . . @ @ @ @ . . @ @ @ @ . . @ .
@ . . . . . @ . . . . . @ . . . . . . . . . . . @ . . . . . . .
80
2 10 8 14
5 4 15 17
1 17 23 5
8 18 5 17
7 4 19 7
16 13 11 2
29 17 14 10
20 28 16 2
7 6 17 28
22 11 5 2
17 16 11 13
10 2 26 26
9 19 14 4
7 26 2 22
10 26 8 20
16 7 20 22
22 26 10 23
11 12 9 13
16 5 19 3
4 2 2 5
26 15 4 17
23 17 22 30
5 1 21 31
10 10 28 12
1 22 4 26
15 28 25 29
15 26 4 13
24 8 4 8
9 26 11 25
17 24 25 23
22 6 18 29
18 19 11 11
23 13 26 13
7 14 16 23
25 22 28 5
22 5 2 12
19 28 17 26
13 19 28 13
29 25 8 7
5 9 26 9
4 11 17 29
10 31 5 28
26 30 1 31
2 16 8 11
22 19 20 27
10 30 18 4
14 26 28 21
17 15 25 21
19 5 2 9
20 14 30 5
28 14 11 4
2 4 19 26
25 7 14 14
13 14 25 18
1 10 25 16
16 20 8 1
2 18 31 17
24 1 7 17
19 9 29 11
1 8 22 27
5 12 1 5
31 7 10 8
29 13 10 18
4 12 25 12
17 7 14 8
10 3 1 25
3 1 13 9
1 21 8 23
26 14 23 2
7 9 24 13
2 2 17 17
14 16 13 1
3 29 11 18
25 17 14 5
14 24 4 4
11 31 11 7
24 19 25 11
30 17 22 23
10 13 13 25
12 26 16 10
